R 1080 720 
NO ./textures/metal.xpm
SO ./textures/brick.xpm
WE ./textures/grass.xpm
EA ./textures/stone.xpm
S ./textures/wood.xpm
F 180,180,180
C 47,47,47
NE map2.cub
1 1 1 1 1 1 1 1 1 1 1 1 1 1
1 0 0 0 0 1 0 0 0 0 0 0 0 1
1 0 0 0 0 0 0 1 1 1 1 1 0 1
1 0 0 0 0 1 0 0 1 0 0 0 0 1
1 0 0 0 0 0 0 1 1 0 0 0 0 1
1 0 0 0 0 1 0 0 1 0 1 1 0 1
1 0 0 0 0 0 0 1 1 0 1 1 0 1
1 0 0 0 0 1 0 0 1 0 1 1 0 1
1 0 0 0 0 0 0 1 1 0 0 0 0 1
1 0 0 0 0 1 0 0 1 0 0 0 0 1
1 0 0 0 0 0 0 1 1 1 1 1 0 1
1 0 0 0 0 1 N 0 0 0 0 0 0 1
1 0 0 0 0 0 0 1 1 6 6 6 6 1
1 0 0 0 0 1 0 0 5 0 0 0 0 1
1 0 0 0 0 0 0 1 1 1 0 0 0 1
1 0 0 0 0 1 0 0 1 1 1 1 1 1
1 0 0 0 0 0 0 1 1 0 0 0 0 1
1 0 0 0 0 1 0 0 1 0 0 0 0 1
1 0 0 0 0 0 0 1 1 0 0 0 0 1
1 0 0 0 0 1 0 0 1 0 0 0 0 1
1 1 1 1 0 1 0 1 1 1 1 1 3 1 1 1 1
1 1 0 0 0 1 0 0 3 0 0 0 0 3 0 0 1
1 0 0 0 0 1 0 1 1 1 1 1 3 1 1 1 1
1 1 0 1 1 1 0 1 1 1 0 0 0 1
1 0 0 1 0 1 0 1 0 1 0 0 0 1
1 0 0 1 0 0 0 0 0 1 0 0 0 1
1 0 0 1 0 0 0 1 0 1 1 1 1 1
1 0 0 0 0 1 0 0 0 1
1 0 0 0 0 0 0 0 1 1
1 0 2 0 0 0 0 0 1
1 4 0 0 0 0 0 0 1
1 2 0 0 0 0 0 0 1
1 1 1 1 1 1 1 1 1
