R 1080 720 
NO ./textures/bluestone.xpm
SO ./textures/greystone.xpm
WE ./textures/purplestone.xpm
EA ./textures/stone.xpm
S ./textures/wood.xpm
F ./textures/grass.xpm
C ./textures/colorstone.xpm
NE map1.cub
LI 1 2 2 100
1 1 1 1 1 1 1 1 1 1 1 1 1 1
1 0 0 0 0 0 0 1 1 0 0 0 0 1
1 0 0 0 0 1 0 0 1 0 0 0 0 1
1 0 0 0 0 0 0 1 1 0 0 0 0 1
1 0 0 0 0 1 0 0 1 0 0 0 0 1
1 1 1 1 0 1 0 0 0 1 1 1 1 1 1 1 1
1 1 0 0 0 1 0 0 0 0 0 0 0 0 0 W 1
1 0 0 0 0 1 0 0 0 0 1 1 3 1 1 1 1
1 1 0 1 1 1 0 0 0 1 0 0 0 1
1 0 0 1 0 1 0 0 0 1 0 0 0 1
1 0 0 0 0 0 0 0 0 1 0 0 0 1
1 0 0 1 1 1 1 1 1 1 1 1 1 1
1 0 0 0 0 0 0 0 4 1
1 0 0 0 0 0 0 0 1 1
1 0 0 0 0 0 0 0 1
1 0 0 0 0 0 0 0 1
1 0 0 0 0 0 0 0 1
1 1 1 1 1 1 1 1 1
